......................
.-##################-.
.#..................#.
s####-..............#.
.#...#.-############-.
.#...#.#..............
.#...#.#..............
.-###-.#..............
..#####-..............
......................

