.........................
...........-#####-.......
...........#.....#.......
...........#.....#.......
...-###-...#.....#.......
...#...#...#.....#.......
...#...#...#.....-#######
s##-...#...#.............
.......#...#.............
...-###-...#.............
...#.......#.............
...#.......#.............
...-#######-.............
.........................
