.........................
.........................
s##-.....................
...#.....................
...#.....................
...#.....-#######-.......
...#.....#.......#.......
...#.....#.......#.......
...#.....#.......#.......
...#.....#.......#.......
...-#####-.......#.......
.................#.......
.................-#######
.........................
.........................
