.......................
.-##################-..
.#..................#..
s####-.-############-..
.#...#.#...............
.#...#.#...............
.#...#.#...............
.-###-.#...............
.......-##############g
.......................
.......................