.........................
...........-#####-.......
...........#.....#.......
...........#.....#.......
...-###-...#.....#.......
...#...#...#.....#.......
...#...#...#.....-#######
s##-...#...#.............
.......#...#....#..#..#.
...-###-...#....###.###..
...#.......#......#.#....
...#.......#......#.#....
...-#######-.......#.....
.........................
