.......................
.......................
s################-.....
.................#.....
.......-####-....#.....
.......#....#....#.....
....-##-....-####-.....
....#..................
....#.......-####-.....
....#.......#....#.....
....-##-....#....#.....
.......#....#....#.....
.......-####-....#.....
.................#.....
g################-.....
.......................